111111
11P001
11C001
11E001
111111